############################################################
#..........................................................#
#..########........########........########........#####...#
#..#......#........#......#........#......#........#...#...#
#..#......#........#...............#......#........#...#...#
#..#......#........#...............#......#........#...#...#
#..#......#........#......................#........#...#...#
#..#......#........#......#........#......#........#...#...#
#..#......#........#......#........#......#........#####...#
#..###..###........###..###........###..###................#
#.....##..............##..............##...................#
#.....##..............##..............##...................#
#..###..###........###..###........###..###................#
#..#......#........#......#........#......#........#####...#
#..#......#........#......#........#......#........#...#...#
#..#......#........#......#........#......#........#...#...#
#..#......#........#......#........#......#........#...#...#
#..#......#........#......#........#......#........#...#...#
#..#......#........#......#........#......#........#...#...#
#..########........########........########........#####...#
#..........................................................#
#..........................................................#
#..........................................................#
#..........................................................#
#.............#############################................#
#.............#...........................#................#
#.............#...........................#................#
#.............#...........................#................#
#.............#...........................#................#
#.............#...........................#................#
#.............#...............O...........#................#
#.............#...........................#................#
#.............#...........................#................#
#..............##...................##.....................#
#..........................................................#
#..........................................................#
#..........................................................#
#..........................................................#
#..........................................................#
#..########........########........########.....########...#
#..#......#........#......#........#......#.....#......#...#
#..#......#........#......#........#......#.....#......#...#
#..#......#........#......#........#......#.....#......#...#
#..#......#........#......#........#......#.....#......#...#
#..#......#........#......#........#......#.....#......#...#
#..#......#........#......#........#......#.....#......#...#
#..###..###........###..###........###..###.....###..###...#
#..........................................................#
#..........................................................#
#..###..###........###..###........###..###................#
#..#......#........#......#........#......#........#####...#
#..#......#........#......#........#......#........#...#...#
#..#......#........#......#........#......#........#...#...#
#..#......#........#......#........#......#........#...#...#
#..#......#........#......#........#......#........#...#...#
#..#......#........#......#........#......#........#...#...#
#..########........########........########........#####...#
#..........................................................#
#..........................................................#
############################################################
