############################################################
#..........................................................#
#..########........########........########........#####..#
#..#......#........#......#........#......#........#...#..#
#..#......#........#......#........#......#........#...#..#
#..#......#........#......#........#......#........#...#..#
#..#......#........#......#........#......#........#...#..#
#..#......#........#......#........#......#........#...#..#
#..#......#........#......#........#......#........#####..#
#..###..###........###..###........###..###................#
#.....##..............##..............##...................#
#.....##..............##..............##...................#
#..###..###........###..###........###..###................#
#..#......#........#......#........#......#........#####..#
#..#......#........#......#........#......#........#...#..#
#..#......#........#......#........#......#........#...#..#
#..#......#........#......#........#......#........#...#..#
#..#......#........#......#........#......#........#...#..#
#..#......#........#......#........#......#........#...#..#
#..########........########........########........#####..#
#..........................................................#
#..........................................................#
#..........................................................#
#..........................................................#
#.............#############################................#
#.............#...........................#................#
#.............#...........................#................#
#.............#...........................#................#
#.............#...........................#................#
#.............#...........................#................#
#.............#...............O...........#................#
#.............#...........................#................#
#.............#...........................#................#
#..............##...................##.....................#
#..........................................................#
#..........................................................#
#..........................................................#
#..........................................................#
#..........................................................#
#..########........########........########........#####..#
#..#......#........#......#........#......#........#...#..#
#..#......#........#......#........#......#........#...#..#
#..#......#........#......#........#......#........#...#..#
#..#......#........#......#........#......#........#...#..#
#..#......#........#......#........#......#........#...#..#
#..#......#........#......#........#......#........#####..#
#..###..###........###..###........###..###................#
#.....##..............##..............##...................#
#.....##..............##..............##...................#
#..###..###........###..###........###..###................#
#..#......#........#......#........#......#........#####..#
#..#......#........#......#........#......#........#...#..#
#..#......#........#......#........#......#........#...#..#
#..#......#........#......#........#......#........#...#..#
#..#......#........#......#........#......#........#...#..#
#..#......#........#......#........#......#........#...#..#
#..########........########........########........#####..#
#..........................................................#
#..........................................................#
############################################################
