####################
#..................#
#..................#
#..................#
#..................#
#..................#
#..........####....#
#..................#
#...####...........#
#..#...............#
#..#O..............#
#..................#
#..................#
#..................#
#O.................#
#.............O....#
#..................#
#..........O.......#
#..................#
####################
