####################
#..................#
#...........O......#
#.................O#
#..................#
#..................#
#...........####...#
#............#####.#
#..................#
#........O.........#
#..................#
#..................#
#..................#
#..................#
#..................#
#............O.....#
#..................#
#.......##.........#
#..................#
####################
